 _____________    _____________
|             |__|             |
|   Bedroom    __   Bathroom   |
|             |  |             |
|_____   _____|  |_____________|
      | |
  ____| |____    ______________
 |           |  |              |
 |           |  |              |
 |           |__|              |
 |  Hallway   __    Kitchen    |
 |     X     |  |              |
 |           |  |              |
 |____   ____|  |______________|
      | |