 _____________    _____________
|             |__|             |
|   Bedroom    __   Bathroom   |
|             |  |      X      |
|_____   _____|  |_____________|
      | |
  ____| |____    ______________
 |           |  |              |
 |           |  |              |
 |           |__|              |
 |  Hallway   __    Kitchen    |
 |           |  |              |
 |           |  |              |
 |____   ____|  |______________|
      | |